""
DialogScript	DialogScript
CreateScript	CreateScript
TypePropertiesOptions	TypePropertiesOptions
Help	Help
Tools.shelf	Tools.shelf
InternalFileOptions	InternalFileOptions
Contents.gz	Contents.gz
EditableNodes	EditableNodes
DescriptiveParmName	DescriptiveParmName
IconSVG	IconSVG
OnCreated	OnCreated
PythonModule	PythonModule
ExtraFileOptions	ExtraFileOptions
mops__cloner__03.svg	mops_cloner_03.svg
mops__logo__01.svg	mops_logo_01.svg
mops__instancing.svg	mops_instancing.svg
mops__update.svg	mops_update.svg
mops__expand.svg	mops_expand.svg
mops__collapse.svg	mops_collapse.svg
mops__wiki.svg	mops_wiki.svg
mops__donate.svg	mops_donate.svg
mops__feedback.svg	mops_feedback.svg
